WWWWWWW
WSPPPPW
WWWWWPW
WPPGWPW
WPWWWPW
WPWPWPW
WPWPWPW
WPPPPPW
WWWWWWW