WWWWWWW
WSPPPPW
WWWWWPW
WPPGWPW
WPWWWPW
WPWPPPW
WPWPPPW
WPPPPPW
WWWWWWW