WWWWWWWWW
WSWPPPPPW
WPWPWWWPW
WPWGWPPPW
WPWWWWWPW
WPPPPPPPW
WWWWWWWWW
